[1,18,16,0,0,0,0,0,0,0,0,255][1,18,16,0,0,0,0,0,0,0,0,255][1,18,16,0,0,0,0,0,0,0,0,255][1,18,16,0,0,0,0,0,0,0,0,255][1,18,16,0,0,0,0,0,0,0,0,255][1,18,16,0,0,0,0,0,0,0,0,255][1,18,16,0,0,0,0,0,0,0,0,255]
[1,18,16,0,0,0,0,0,0,0,0,255][0,18,16,0,0,0,0,1,0,0,0,255][0,18,16,0,0,0,0,1,0,0,0,255][0,18,16,0,0,0,0,1,0,0,0,255][0,18,16,0,0,0,0,1,0,0,0,255][8,18,16,0,0,0,3,1,0,0,0,255][1,18,16,0,0,0,0,0,0,0,0,255]
[1,18,16,0,0,0,0,0,0,0,0,255][0,18,16,0,0,0,0,1,0,0,0,255][1,18,16,0,0,0,2,0,0,0,0,255][0,18,16,0,0,0,0,1,0,0,0,255][0,18,16,0,0,0,0,1,0,0,0,255][0,18,16,0,0,0,0,1,0,0,0,255][1,18,16,0,0,0,0,0,0,0,0,255]
[1,18,16,0,0,0,0,0,0,0,0,255][0,18,16,0,0,0,0,1,0,0,0,255][11,18,16,1,0,1,0,0,0,0,0,255][0,18,16,0,0,0,0,1,0,0,0,255][0,18,16,0,0,0,0,1,0,0,0,255][2,18,16,0,0,0,0,1,0,0,0,255][1,18,16,0,0,0,0,0,0,0,0,255]
[1,18,16,0,0,0,0,0,0,0,0,255][0,18,16,0,0,0,0,1,0,0,0,255][1,18,16,0,2,0,0,0,0,0,0,255][0,18,16,0,0,0,0,1,0,0,0,255][0,18,16,0,0,0,0,1,0,0,0,255][0,18,16,0,0,0,0,1,0,0,0,255][1,18,16,0,0,0,0,0,0,0,0,255]
[1,18,16,0,0,0,0,0,0,0,0,255][0,18,16,0,0,0,0,1,0,0,0,255][0,18,16,0,0,0,0,1,0,0,0,255][0,18,16,0,0,0,0,1,0,0,0,255][0,18,16,0,0,0,0,1,0,0,0,255][7,18,16,0,0,0,3,1,0,0,0,255][1,18,16,0,0,0,0,0,0,0,0,255]
[1,18,16,0,0,0,0,0,0,0,0,255][1,18,16,0,0,0,0,0,0,0,0,255][1,18,16,0,0,0,0,0,0,0,0,255][1,18,16,0,0,0,0,0,0,0,0,255][1,18,16,0,0,0,0,0,0,0,0,255][1,18,16,0,0,0,0,0,0,0,0,255][1,18,16,0,0,0,0,0,0,0,0,255]
