[1,18,16,0,0,0,0,0,0,0,0,255][1,18,16,0,0,0,0,0,0,0,0,255][1,18,16,0,0,0,0,0,0,0,0,255][1,18,16,0,0,0,0,0,0,0,0,255][1,18,16,0,0,0,0,0,0,0,0,255][1,18,16,0,0,0,0,0,0,0,0,255][1,18,16,0,0,0,0,0,0,0,0,255]
[1,18,16,0,0,0,0,0,0,0,0,255][0,17,16,0,0,0,0,1,0,0,0,255][0,17,16,0,0,0,0,1,0,0,0,255][0,17,16,0,0,0,0,1,0,0,0,255][0,17,16,0,0,0,0,1,0,0,0,255][8,17,16,0,0,0,3,1,0,0,0,255][1,18,16,0,0,0,0,0,0,0,0,255]
[1,18,16,0,0,0,0,0,0,0,0,255][0,17,16,0,0,0,0,1,0,0,0,255][1,17,16,0,0,0,1,0,0,0,0,255][0,17,16,0,0,0,0,1,0,0,0,255][0,17,16,0,0,0,0,1,0,0,0,255][0,17,16,0,0,0,0,1,0,0,0,255][1,18,16,0,0,0,0,0,0,0,0,255]
[1,18,16,0,0,0,0,0,0,0,0,255][0,17,16,0,0,0,0,1,0,0,0,255][11,18,16,6,0,6,0,0,0,0,0,255][0,17,16,0,0,0,0,1,0,0,0,255][0,17,16,0,0,0,0,1,0,0,0,255][2,17,16,0,0,0,0,1,0,0,0,255][1,18,16,0,0,0,0,0,0,0,0,255]
[1,18,16,0,0,0,0,0,0,0,0,255][0,17,16,0,0,0,0,1,0,0,0,255][1,17,16,0,0,0,0,0,0,0,0,255][0,17,16,0,0,0,0,1,0,0,0,255][0,17,16,0,0,0,0,1,0,0,0,255][0,17,16,0,0,0,0,1,0,0,0,255][1,18,16,0,0,0,0,0,0,0,0,255]
[1,18,16,0,0,0,0,0,0,0,0,255][0,17,16,0,0,0,0,1,0,0,0,255][0,17,16,0,0,0,0,1,0,0,0,255][0,17,16,0,0,0,0,1,0,0,0,255][0,17,16,0,0,0,0,1,0,0,0,255][7,17,16,0,0,0,3,1,0,0,0,255][1,18,16,0,0,0,0,0,0,0,0,255]
[1,18,16,0,0,0,0,0,0,0,0,255][1,18,16,0,0,0,0,0,0,0,0,255][1,18,16,0,0,0,0,0,0,0,0,255][1,18,16,0,0,0,0,0,0,0,0,255][1,18,16,0,0,0,0,0,0,0,0,255][1,18,16,0,0,0,0,0,0,0,0,255][1,18,16,0,0,0,0,0,0,0,0,255]
