1 1     1 1 1 1 1 1 1 1
1 0     0 0 0 0 0 0 8 1
1 0     8 4 0 4 0 4 0 1
1 35,10 1 4 4 4 4 4 2 1
1 0     7 4 0 4 0 4 0 1
1 0     0 0 0 0 0 0 0 1
1 1     1 0 0 0 0 0 0 1
1 1     1 1 1 1 1 1 0 1
1 1     1 0 1 0 0 0 0 1
1 0     0 1 1 0 8 0 0 1
1 0     0 1 8 0 1 0 0 1
1 0     0 1 1 0 7 0 0 1
1 0     0 0 1 0 0 0 0 1
1 1     1 1 1 1 1 1 1 1