[1,18,16,0,0,0,0,0,0,0,0,255,0][1,18,16,0,0,0,0,0,0,0,0,255,0][1,18,16,0,0,0,0,0,0,0,0,255,0][1,18,16,0,0,0,0,0,0,0,0,255,0][1,18,16,0,0,0,0,0,0,0,0,255,0][1,18,16,0,0,0,0,0,0,0,0,255,0][1,18,16,0,0,0,0,0,0,0,0,255,0][1,18,16,0,0,0,0,0,0,0,0,255,0][1,18,16,0,0,0,0,0,0,0,0,255,0][1,18,16,0,0,0,0,0,0,0,0,255,0][1,18,16,0,0,0,0,0,0,0,0,255,0][1,18,16,0,0,0,0,0,0,0,0,255,0]
[1,18,16,0,0,0,0,0,0,0,0,255,0][0,18,16,0,0,0,0,1,0,0,0,255,0][0,18,16,0,0,0,0,1,0,0,0,255,0][0,18,16,0,0,0,0,1,0,0,0,255,0][0,18,16,0,0,0,0,1,0,0,0,255,0][0,18,16,0,0,0,0,1,0,0,0,255,0][0,18,16,0,0,0,0,1,0,0,0,255,0][0,18,16,0,0,0,0,1,0,0,0,255,0][0,18,16,0,0,0,0,1,0,0,0,255,0][0,18,16,0,0,0,0,1,0,0,0,255,0][0,18,16,0,0,0,0,1,0,0,0,255,0][1,18,16,0,0,0,0,0,0,0,0,255,0]
[1,18,16,0,0,0,0,0,0,0,0,255,0][0,18,16,0,0,0,0,1,0,0,0,255,0][0,18,16,0,0,0,0,1,0,0,0,255,0][0,18,16,0,0,0,0,1,0,0,0,255,0][0,18,16,0,0,0,0,1,0,0,0,255,0][0,18,16,0,0,0,0,1,0,0,0,255,0][0,18,16,0,0,0,0,1,0,0,0,255,0][0,18,16,1,7,2,1,1,0,0,0,255,0][0,18,16,0,0,0,0,1,0,0,0,255,0][0,18,16,0,0,0,0,1,0,0,0,255,0][0,18,16,0,0,0,0,1,0,0,0,255,0][1,18,16,0,0,0,0,0,0,0,0,255,0]
[1,18,16,0,0,0,0,0,0,0,0,255,0][0,18,16,0,0,0,0,1,0,0,0,255,0][9,18,16,0,0,0,0,0,0,0,0,255,0][0,18,16,0,0,0,0,1,0,0,0,255,0][0,18,16,0,0,0,0,1,0,0,0,255,0][0,18,16,0,0,0,0,1,0,0,0,255,0][0,18,16,0,0,0,0,1,0,0,0,255,0][0,18,16,0,0,0,0,1,0,0,0,255,0][0,18,16,0,0,0,0,1,0,0,0,255,0][0,18,16,0,0,0,0,1,0,0,0,255,0][0,18,16,0,0,0,0,1,0,0,0,255,0][1,18,16,0,0,0,0,0,0,0,0,255,0]
[1,18,16,0,0,0,0,0,0,0,0,255,0][0,18,16,0,0,0,0,1,0,0,0,255,0][0,18,16,0,0,0,0,1,0,0,0,255,0][0,18,16,0,0,0,0,1,0,0,0,255,0][0,18,16,0,0,0,0,1,0,0,0,255,0][0,18,16,0,0,0,0,1,0,0,0,255,0][0,18,16,0,0,0,0,1,0,0,0,255,0][0,18,16,0,0,0,0,1,0,0,0,255,0][0,18,16,0,0,0,0,1,0,0,0,255,0][0,18,16,0,0,0,0,1,0,0,0,255,0][0,18,16,0,0,0,0,1,0,0,0,255,0][1,18,16,0,0,0,0,0,0,0,0,255,0]
[1,18,16,0,0,0,0,0,0,0,0,255,0][0,18,16,0,0,0,0,1,0,0,0,255,0][0,18,16,0,0,0,0,1,0,0,0,255,0][0,18,16,0,0,0,0,1,0,0,0,255,0][0,18,16,0,0,0,0,1,0,0,0,255,0][0,18,16,0,0,0,0,1,0,0,0,255,0][9,18,16,0,0,0,0,0,0,0,0,255,0][0,18,16,0,0,0,0,1,0,0,0,255,0][0,18,16,0,0,0,0,1,0,0,0,255,0][0,18,16,0,0,0,0,1,0,0,0,255,0][0,18,16,0,0,0,0,1,0,0,0,255,0][1,18,16,0,0,0,0,0,0,0,0,255,0]
[1,18,16,0,0,0,0,0,0,0,0,255,0][1,17,16,0,0,0,0,0,0,0,0,255,0][1,17,16,0,0,0,0,1,0,0,0,255,0][1,17,16,0,0,0,0,0,0,0,0,255,0][8,18,16,0,0,0,0,0,0,0,0,255,0][0,18,16,0,0,0,0,1,0,0,0,255,0][0,18,16,0,0,0,0,1,0,0,0,255,0][9,18,16,0,0,0,0,0,0,0,0,255,0][10,18,16,0,0,0,0,1,0,0,0,255,0][1,18,16,0,0,0,0,0,0,0,0,255,0][8,18,16,0,0,0,0,0,0,0,0,255,0][1,18,16,0,0,0,0,0,0,0,0,255,0]
[1,18,16,0,0,0,0,0,0,0,0,255,0][0,17,16,0,0,0,0,1,0,0,0,255,0][1,17,16,0,0,0,0,1,0,0,0,255,0][1,17,16,0,0,0,0,1,0,0,0,255,0][1,17,16,0,0,0,0,0,0,0,0,255,0][0,18,16,0,0,0,0,1,0,0,0,255,0][0,18,16,0,0,0,0,1,0,0,0,255,0][7,18,16,0,0,0,0,1,0,0,0,255,0][0,18,16,0,0,0,0,1,0,0,0,255,0][0,18,16,0,0,0,0,1,0,0,0,255,0][1,18,16,0,0,0,0,0,0,0,0,255,0][1,18,16,0,0,0,0,0,0,0,0,255,0]
[1,18,16,0,0,0,0,0,0,0,0,255,0][1,17,16,2,2,2,2,0,0,0,0,255,0][0,17,16,0,0,0,0,1,0,0,0,255,0][0,17,16,0,0,0,0,1,0,0,0,255,0][0,17,17,2,2,2,2,1,0,0,0,255,0][0,18,17,0,0,0,0,1,0,0,0,255,0][0,18,17,0,0,0,0,1,0,0,0,255,0][9,18,17,0,0,0,0,0,0,0,0,255,0][0,18,17,0,0,0,0,1,0,0,0,255,0][2,18,17,0,0,0,0,1,0,0,0,255,0][10,18,16,0,0,0,0,0,0,0,0,255,0][1,18,16,0,0,0,0,0,0,0,0,255,0]
[1,18,16,0,0,0,0,0,0,0,0,255,0][0,17,16,0,0,0,0,1,0,0,0,255,0][0,17,16,0,0,0,0,1,0,0,0,255,0][0,17,16,0,0,0,0,1,0,0,0,255,0][1,17,16,0,0,0,0,0,0,0,0,255,0][0,18,16,0,0,0,0,1,0,0,0,255,0][0,18,16,0,0,0,0,1,0,0,0,255,0][8,18,16,0,0,0,0,1,0,0,0,255,0][0,18,16,0,0,0,0,1,0,0,0,255,0][0,18,16,0,0,0,0,1,0,0,0,255,0][1,18,16,0,0,0,0,0,0,0,0,255,0][1,18,16,0,0,0,0,0,0,0,0,255,0]
[1,18,16,0,0,0,0,0,0,0,0,255,0][1,17,16,0,0,0,0,0,0,0,0,255,0][10,17,16,0,0,0,0,1,0,0,0,255,0][1,17,16,0,0,0,0,0,0,0,0,255,0][7,18,16,0,0,0,0,0,0,0,0,255,0][0,18,16,0,0,0,0,1,0,0,0,255,0][0,18,16,0,0,0,0,1,0,0,0,255,0][9,18,16,0,0,0,0,0,0,0,0,255,0][10,18,16,0,0,0,0,1,0,0,0,255,0][1,18,16,0,0,0,0,0,0,0,0,255,0][7,18,16,0,0,0,0,0,0,0,0,255,0][1,18,16,0,0,0,0,0,0,0,0,255,0]
[1,18,16,0,0,0,0,0,0,0,0,255,0][0,18,16,0,0,0,0,1,0,0,0,255,0][0,18,16,0,0,0,0,1,0,0,0,255,0][0,18,16,0,0,0,0,1,0,0,0,255,0][0,18,16,0,0,0,0,1,0,0,0,255,0][0,18,16,0,0,0,0,1,0,0,0,255,0][9,18,16,0,0,0,0,0,0,0,0,255,0][0,18,16,0,0,0,0,1,0,0,0,255,0][0,18,16,0,0,0,0,1,0,0,0,255,0][0,18,16,0,0,0,0,1,0,0,0,255,0][0,18,16,0,0,0,0,1,0,0,0,255,0][1,18,16,0,0,0,0,0,0,0,0,255,0]
[1,18,16,0,0,0,0,0,0,0,0,255,0][0,18,16,0,0,0,0,1,0,0,0,255,0][0,18,16,0,0,0,0,1,0,0,0,255,0][0,18,16,0,0,0,0,1,0,0,0,255,0][0,18,16,0,0,0,0,1,0,0,0,255,0][0,18,16,0,0,0,0,1,0,0,0,255,0][0,18,16,0,0,0,0,1,0,0,0,255,0][0,18,16,0,0,0,0,1,0,0,0,255,0][0,18,16,0,0,0,0,1,0,0,0,255,0][0,18,16,0,0,0,0,1,0,0,0,255,0][0,18,16,0,0,0,0,1,0,0,0,255,0][1,18,16,0,0,0,0,0,0,0,0,255,0]
[1,18,16,0,0,0,0,0,0,0,0,255,0][0,18,16,0,0,0,0,1,0,0,0,255,0][9,18,16,0,0,0,0,0,0,0,0,255,0][0,18,16,0,0,0,0,1,0,0,0,255,0][0,18,16,0,0,0,0,1,0,0,0,255,0][0,18,16,0,0,0,0,1,0,0,0,255,0][0,18,16,0,0,0,0,1,0,0,0,255,0][0,18,16,0,0,0,0,1,0,0,0,255,0][0,18,16,0,0,0,0,1,0,0,0,255,0][0,18,16,0,0,0,0,1,0,0,0,255,0][0,18,16,0,0,0,0,1,0,0,0,255,0][1,18,16,0,0,0,0,0,0,0,0,255,0]
[1,18,16,0,0,0,0,0,0,0,0,255,0][0,18,16,0,0,0,0,1,0,0,0,255,0][0,18,16,0,0,0,0,1,0,0,0,255,0][0,18,16,0,0,0,0,1,0,0,0,255,0][0,18,16,0,0,0,0,1,0,0,0,255,0][0,18,16,0,0,0,0,1,0,0,0,255,0][0,18,16,0,0,0,0,1,0,0,0,255,0][0,18,16,0,0,0,0,1,0,0,0,255,0][0,18,16,0,0,0,0,1,0,0,0,255,0][0,18,16,0,0,0,0,1,0,0,0,255,0][0,18,16,0,0,0,0,1,0,0,0,255,0][1,18,16,0,0,0,0,0,0,0,0,255,0]
[1,18,16,0,0,0,0,0,0,0,0,255,0][0,18,16,0,0,0,0,1,0,0,0,255,0][0,18,16,0,0,0,0,1,0,0,0,255,0][0,18,16,0,0,0,0,1,0,0,0,255,0][0,18,16,0,0,0,0,1,0,0,0,255,0][0,18,16,0,0,0,0,1,0,0,0,255,0][0,18,16,0,0,0,0,1,0,0,0,255,0][0,18,16,0,0,0,0,1,0,0,0,255,0][0,18,16,0,0,0,0,1,0,0,0,255,0][0,18,16,0,0,0,0,1,0,0,0,255,0][0,18,16,0,0,0,0,1,0,0,0,255,0][1,18,16,0,0,0,0,0,0,0,0,255,0]
[1,18,16,0,0,0,0,0,0,0,0,255,0][1,18,16,0,0,0,0,0,0,0,0,255,0][1,18,16,0,0,0,0,0,0,0,0,255,0][1,18,16,0,0,0,0,0,0,0,0,255,0][1,18,16,0,0,0,0,0,0,0,0,255,0][1,18,16,0,0,0,0,0,0,0,0,255,0][1,18,16,0,0,0,0,0,0,0,0,255,0][1,18,16,0,0,0,0,0,0,0,0,255,0][1,18,16,0,0,0,0,0,0,0,0,255,0][1,18,16,0,0,0,0,0,0,0,0,255,0][1,18,16,0,0,0,0,0,0,0,0,255,0][1,18,16,0,0,0,0,0,0,0,0,255,0]
