[1,10,9,0,0,0,0,0,0,0,0,255][1,10,9,0,0,0,0,0,0,0,0,255][1,10,9,0,0,0,0,0,0,0,0,255][1,10,9,0,0,0,0,0,0,0,0,255][1,10,9,0,0,0,0,0,0,0,0,255][1,10,9,0,0,0,0,0,0,0,0,255][1,10,9,0,0,0,0,0,0,0,0,255][1,10,9,0,0,0,0,0,0,0,0,255][1,10,9,0,0,0,0,0,0,0,0,255][1,10,9,0,0,0,0,0,0,0,0,255][1,10,9,0,0,0,0,0,0,0,0,255][1,10,9,0,0,0,0,0,0,0,0,255]
[1,10,9,0,0,0,0,0,0,0,0,255][0,10,9,0,0,0,0,1,0,0,0,255][0,10,9,0,0,0,0,1,0,0,0,255][0,10,9,0,0,0,0,1,0,0,0,255][0,10,9,0,0,0,0,1,0,0,0,255][0,10,9,0,0,0,0,1,0,0,0,255][0,10,9,0,0,0,0,1,0,0,0,255][0,10,9,0,0,0,0,1,0,0,0,255][0,10,9,0,0,0,0,1,0,0,0,255][0,10,9,0,0,0,0,1,0,0,0,255][0,10,9,0,0,0,0,1,0,0,0,255][1,10,9,0,0,0,0,0,0,0,0,255]
[1,10,9,0,0,0,0,0,0,0,0,255][0,10,9,0,0,0,0,1,0,0,0,255][0,10,9,0,0,0,0,1,0,0,0,255][0,10,9,0,0,0,0,1,0,0,0,255][0,10,9,0,0,0,0,1,0,0,0,255][0,10,9,0,0,0,0,1,0,0,0,255][0,10,9,0,0,0,0,1,0,0,0,255][0,10,9,1,7,2,1,1,0,0,0,255][0,10,9,0,0,0,0,1,0,0,0,255][0,10,9,0,0,0,0,1,0,0,0,255][0,10,9,0,0,0,0,1,0,0,0,255][1,10,9,0,0,0,0,0,0,0,0,255]
[1,10,9,0,0,0,0,0,0,0,0,255][0,10,9,0,0,0,0,1,0,0,0,255][9,10,9,0,0,0,0,0,0,0,0,255][0,10,9,0,0,0,0,1,0,0,0,255][0,10,9,0,0,0,0,1,0,0,0,255][0,10,9,0,0,0,0,1,0,0,0,255][0,10,9,0,0,0,0,1,0,0,0,255][0,10,9,0,0,0,0,1,0,0,0,255][0,10,9,0,0,0,0,1,0,0,0,255][0,10,9,0,0,0,0,1,0,0,0,255][0,10,9,0,0,0,0,1,0,0,0,255][1,10,9,0,0,0,0,0,0,0,0,255]
[1,10,9,0,0,0,0,0,0,0,0,255][0,10,9,0,0,0,0,1,0,0,0,255][0,10,9,0,0,0,0,1,0,0,0,255][0,10,9,0,0,0,0,1,0,0,0,255][0,10,9,0,0,0,0,1,0,0,0,255][0,10,9,0,0,0,0,1,0,0,0,255][0,10,9,0,0,0,0,1,0,0,0,255][0,10,9,0,0,0,0,1,0,0,0,255][0,10,9,0,0,0,0,1,0,0,0,255][0,10,9,0,0,0,0,1,0,0,0,255][0,10,9,0,0,0,0,1,0,0,0,255][1,10,9,0,0,0,0,0,0,0,0,255]
[1,10,9,0,0,0,0,0,0,0,0,255][0,10,9,0,0,0,0,1,0,0,0,255][0,10,9,0,0,0,0,1,0,0,0,255][0,10,9,0,0,0,0,1,0,0,0,255][0,10,9,0,0,0,0,1,0,0,0,255][0,10,9,0,0,0,0,1,0,0,0,255][9,10,9,0,0,0,0,0,0,0,0,255][0,10,9,0,0,0,0,1,0,0,0,255][0,10,9,0,0,0,0,1,0,0,0,255][0,10,9,0,0,0,0,1,0,0,0,255][0,10,9,0,0,0,0,1,0,0,0,255][1,10,9,0,0,0,0,0,0,0,0,255]
[1,10,9,0,0,0,0,0,0,0,0,255][1,17,9,0,0,0,0,0,0,0,0,255][1,17,9,0,0,0,0,1,0,0,0,255][1,17,9,0,0,0,0,0,0,0,0,255][8,10,9,0,0,0,0,0,0,0,0,255][0,10,9,0,0,0,0,1,0,0,0,255][0,10,9,0,0,0,0,1,0,0,0,255][9,10,9,0,0,0,0,0,0,0,0,255][10,10,9,0,0,0,0,1,0,0,0,255][1,10,9,0,0,0,0,0,0,0,0,255][8,10,9,0,0,0,0,0,0,0,0,255][1,10,9,0,0,0,0,0,0,0,0,255]
[1,10,9,0,0,0,0,0,0,0,0,255][0,17,9,0,0,0,0,1,0,0,0,255][1,17,9,0,0,0,0,1,0,0,0,255][1,17,9,0,0,0,0,1,0,0,0,255][1,17,9,0,0,0,0,0,0,0,0,255][0,10,9,0,0,0,0,1,0,0,0,255][0,10,9,0,0,0,0,1,0,0,0,255][7,10,9,0,0,0,0,1,0,0,0,255][0,10,9,0,0,0,0,1,0,0,0,255][0,10,9,0,0,0,0,1,0,0,0,255][1,10,9,0,0,0,0,0,0,0,0,255][1,10,9,0,0,0,0,0,0,0,0,255]
[1,10,9,0,0,0,0,0,0,0,0,255][1,17,9,2,2,2,2,0,0,0,0,255][0,17,9,0,0,0,0,1,0,0,0,255][0,17,9,0,0,0,0,1,0,0,0,255][0,17,17,2,2,2,2,1,0,0,0,255][0,10,17,0,0,0,0,1,0,0,0,255][0,10,17,0,0,0,0,1,0,0,0,255][9,10,17,0,0,0,0,0,0,0,0,255][0,10,17,0,0,0,0,1,0,0,0,255][2,10,17,0,0,0,0,1,0,0,0,255][10,10,9,0,0,0,0,0,0,0,0,255][1,10,9,0,0,0,0,0,0,0,0,255]
[1,10,9,0,0,0,0,0,0,0,0,255][0,17,9,0,0,0,0,1,0,0,0,255][0,17,9,0,0,0,0,1,0,0,0,255][0,17,9,0,0,0,0,1,0,0,0,255][1,17,9,0,0,0,0,0,0,0,0,255][0,10,9,0,0,0,0,1,0,0,0,255][0,10,9,0,0,0,0,1,0,0,0,255][8,10,9,0,0,0,0,1,0,0,0,255][0,10,9,0,0,0,0,1,0,0,0,255][0,10,9,0,0,0,0,1,0,0,0,255][1,10,9,0,0,0,0,0,0,0,0,255][1,10,9,0,0,0,0,0,0,0,0,255]
[1,10,9,0,0,0,0,0,0,0,0,255][1,17,9,0,0,0,0,0,0,0,0,255][10,17,9,0,0,0,0,1,0,0,0,255][1,17,9,0,0,0,0,0,0,0,0,255][7,10,9,0,0,0,0,0,0,0,0,255][0,10,9,0,0,0,0,1,0,0,0,255][0,10,9,0,0,0,0,1,0,0,0,255][9,10,9,0,0,0,0,0,0,0,0,255][10,10,9,0,0,0,0,1,0,0,0,255][1,10,9,0,0,0,0,0,0,0,0,255][7,10,9,0,0,0,0,0,0,0,0,255][1,10,9,0,0,0,0,0,0,0,0,255]
[1,10,9,0,0,0,0,0,0,0,0,255][0,10,9,0,0,0,0,1,0,0,0,255][0,10,9,0,0,0,0,1,0,0,0,255][0,10,9,0,0,0,0,1,0,0,0,255][0,10,9,0,0,0,0,1,0,0,0,255][0,10,9,0,0,0,0,1,0,0,0,255][9,10,9,0,0,0,0,0,0,0,0,255][0,10,9,0,0,0,0,1,0,0,0,255][0,10,9,0,0,0,0,1,0,0,0,255][0,10,9,0,0,0,0,1,0,0,0,255][0,10,9,0,0,0,0,1,0,0,0,255][1,10,9,0,0,0,0,0,0,0,0,255]
[1,10,9,0,0,0,0,0,0,0,0,255][0,10,9,0,0,0,0,1,0,0,0,255][0,10,9,0,0,0,0,1,0,0,0,255][0,10,9,0,0,0,0,1,0,0,0,255][0,10,9,0,0,0,0,1,0,0,0,255][0,10,9,0,0,0,0,1,0,0,0,255][0,10,9,0,0,0,0,1,0,0,0,255][0,10,9,0,0,0,0,1,0,0,0,255][0,10,9,0,0,0,0,1,0,0,0,255][0,10,9,0,0,0,0,1,0,0,0,255][0,10,9,0,0,0,0,1,0,0,0,255][1,10,9,0,0,0,0,0,0,0,0,255]
[1,10,9,0,0,0,0,0,0,0,0,255][0,10,9,0,0,0,0,1,0,0,0,255][9,10,9,0,0,0,0,0,0,0,0,255][0,10,9,0,0,0,0,1,0,0,0,255][0,10,9,0,0,0,0,1,0,0,0,255][0,10,9,0,0,0,0,1,0,0,0,255][0,10,9,0,0,0,0,1,0,0,0,255][0,10,9,0,0,0,0,1,0,0,0,255][0,10,9,0,0,0,0,1,0,0,0,255][0,10,9,0,0,0,0,1,0,0,0,255][0,10,9,0,0,0,0,1,0,0,0,255][1,10,9,0,0,0,0,0,0,0,0,255]
[1,10,9,0,0,0,0,0,0,0,0,255][0,10,9,0,0,0,0,1,0,0,0,255][0,10,9,0,0,0,0,1,0,0,0,255][0,10,9,0,0,0,0,1,0,0,0,255][0,10,9,0,0,0,0,1,0,0,0,255][0,10,9,0,0,0,0,1,0,0,0,255][0,10,9,0,0,0,0,1,0,0,0,255][0,10,9,0,0,0,0,1,0,0,0,255][0,10,9,0,0,0,0,1,0,0,0,255][0,10,9,0,0,0,0,1,0,0,0,255][0,10,9,0,0,0,0,1,0,0,0,255][1,10,9,0,0,0,0,0,0,0,0,255]
[1,10,9,0,0,0,0,0,0,0,0,255][0,10,9,0,0,0,0,1,0,0,0,255][0,10,9,0,0,0,0,1,0,0,0,255][0,10,9,0,0,0,0,1,0,0,0,255][0,10,9,0,0,0,0,1,0,0,0,255][0,10,9,0,0,0,0,1,0,0,0,255][0,10,9,0,0,0,0,1,0,0,0,255][0,10,9,0,0,0,0,1,0,0,0,255][0,10,9,0,0,0,0,1,0,0,0,255][0,10,9,0,0,0,0,1,0,0,0,255][0,10,9,0,0,0,0,1,0,0,0,255][1,10,9,0,0,0,0,0,0,0,0,255]
[1,10,9,0,0,0,0,0,0,0,0,255][1,10,9,0,0,0,0,0,0,0,0,255][1,10,9,0,0,0,0,0,0,0,0,255][1,10,9,0,0,0,0,0,0,0,0,255][1,10,9,0,0,0,0,0,0,0,0,255][1,10,9,0,0,0,0,0,0,0,0,255][1,10,9,0,0,0,0,0,0,0,0,255][1,10,9,0,0,0,0,0,0,0,0,255][1,10,9,0,0,0,0,0,0,0,0,255][1,10,9,0,0,0,0,0,0,0,0,255][1,10,9,0,0,0,0,0,0,0,0,255][1,10,9,0,0,0,0,0,0,0,0,255]
