[1,18,16,0,0,0,0,,0,0,0,255][1,18,16,0,0,0,0,,0,0,0,255][1,18,16,0,0,0,0,,0,0,0,255][1,18,16,0,0,0,0,,0,0,0,255][1,18,16,0,0,0,0,,0,0,0,255][1,18,16,0,0,0,0,,0,0,0,255][1,18,16,0,0,0,0,,0,0,0,255][1,18,16,0,0,0,0,,0,0,0,255][1,18,16,0,0,0,0,,0,0,0,255][1,18,16,0,0,0,0,,0,0,0,255][1,18,16,0,0,0,0,,0,0,0,255][1,18,16,0,0,0,0,,0,0,0,255]
[1,18,16,0,0,0,0,,0,0,0,255][0,17,16,0,0,0,0,,0,0,0,255][0,17,16,0,0,0,0,,0,0,0,255][0,17,16,0,0,0,0,,0,0,0,255][0,18,16,0,0,0,0,,0,0,0,255][0,18,16,0,0,0,0,,0,0,0,255][0,18,16,0,0,0,0,,0,0,0,255][0,17,17,0,0,0,0,,0,0,0,255][0,18,16,0,0,0,0,,0,0,0,255][0,18,16,0,0,0,0,,0,0,0,255][0,18,16,0,0,0,0,,0,0,0,255][1,18,16,0,0,0,0,,0,0,0,255]
[1,18,16,0,0,0,0,,0,0,0,255][0,17,16,0,0,0,0,,0,0,0,255][0,17,16,0,0,0,0,,0,0,0,255][0,17,16,0,0,0,0,,0,0,0,255][0,18,16,0,0,0,0,,0,0,0,255][0,18,16,0,0,0,0,,0,0,0,255][0,18,16,0,0,0,0,,1,2,2,255][9,18,16,17,7,2,1,,0,0,0,255][9,18,16,0,0,0,0,,0,0,0,255][9,18,16,0,0,0,0,,0,0,0,255][2,18,16,0,0,0,0,,0,0,0,255][1,18,16,0,0,0,0,,0,0,0,255]
[1,18,16,0,0,0,0,,0,0,0,255][0,17,16,0,0,0,0,,0,0,0,255][0,17,16,0,0,0,0,,0,0,0,255][0,17,16,0,0,0,0,,0,0,0,255][0,18,16,0,0,0,0,,0,0,0,255][0,18,16,0,0,0,0,,0,0,0,255][0,18,16,0,0,0,0,,0,0,0,255][0,17,17,0,0,0,0,,0,0,0,255][0,18,16,0,0,0,0,,0,0,0,255][0,18,16,0,0,0,0,,0,0,0,255][0,18,16,0,0,0,0,,0,0,0,255][1,18,16,0,0,0,0,,0,0,0,255]
[1,18,16,0,0,0,0,,0,0,0,255][1,18,16,0,0,0,0,,0,0,0,255][1,18,16,0,0,0,0,,0,0,0,255][1,18,16,0,0,0,0,,0,0,0,255][1,18,16,0,0,0,0,,0,0,0,255][1,18,16,0,0,0,0,,0,0,0,255][1,18,16,0,0,0,0,,0,0,0,255][1,18,16,0,0,0,0,,0,0,0,255][1,18,16,0,0,0,0,,0,0,0,255][1,18,16,0,0,0,0,,0,0,0,255][1,18,16,0,0,0,0,,0,0,0,255][1,18,16,2,2,2,2,,0,0,0,255]
