[1,18,16,0,0,0,0,,1,2,4][1,18,16,0,0,0,0,,1,2,4][1,18,16,0,0,0,0,,1,2,4][1,18,16,0,0,0,0,,1,2,4][1,18,16,0,0,0,0,,1,2,4][1,18,16,0,0,0,0,,1,2,4][1,18,16,0,0,0,0,,1,2,4][1,18,16,0,0,0,0,,1,2,4][1,18,16,0,0,0,0,,1,2,4][1,18,16,0,0,0,0,,1,2,4][1,18,16,0,0,0,0,,1,2,4][1,18,16,0,0,0,0,,1,2,4]
[1,18,16,0,0,0,0,,1,2,4][0,17,16,0,0,0,0,,1,2,4][0,17,16,0,0,0,0,,1,2,4][0,17,16,0,0,0,0,,1,2,4][0,18,16,0,0,0,0,,1,2,4][0,18,16,0,0,0,0,,1,2,4][0,18,16,0,0,0,0,,1,2,4][0,17,17,0,0,0,0,,1,2,4][0,18,16,0,0,0,0,,1,2,4][0,18,16,0,0,0,0,,1,2,4][0,18,16,0,0,0,0,,1,2,4][1,18,16,0,0,0,0,,1,2,4]
[1,18,16,0,0,0,0,,1,2,4][0,17,16,0,0,0,0,,1,2,4][0,17,16,0,0,0,0,,1,2,4][0,17,16,0,0,0,0,,1,2,4][0,18,16,0,0,0,0,,1,2,4][0,18,16,0,0,0,0,,1,2,4][0,18,16,0,0,0,0,,1,2,4][1,18,16,16,16,16,16,,1,2,4][0,18,16,0,0,0,0,,1,2,4][0,18,16,0,0,0,0,,1,2,4][2,18,16,0,0,0,0,,1,2,4][1,18,16,0,0,0,0,,1,2,4]
[1,18,16,0,0,0,0,,1,2,4][0,17,16,0,0,0,0,,1,2,4][0,17,16,0,0,0,0,,1,2,4][0,17,16,0,0,0,0,,1,2,4][0,18,16,0,0,0,0,,1,2,4][0,18,16,0,0,0,0,,1,2,4][0,18,16,0,0,0,0,,1,2,4][0,17,17,0,0,0,0,,1,2,4][0,18,16,0,0,0,0,,1,2,4][0,18,16,0,0,0,0,,1,2,4][0,18,16,0,0,0,0,,1,2,4][1,18,16,0,0,0,0,,1,2,4]
[1,18,16,0,0,0,0,,1,2,4][1,18,16,0,0,0,0,,1,2,4][1,18,16,0,0,0,0,,1,2,4][1,18,16,0,0,0,0,,1,2,4][1,18,16,0,0,0,0,,1,2,4][1,18,16,0,0,0,0,,1,2,4][1,18,16,0,0,0,0,,1,2,4][1,18,16,0,0,0,0,,1,2,4][1,18,16,0,0,0,0,,1,2,4][1,18,16,0,0,0,0,,1,2,4][1,18,16,0,0,0,0,,1,2,4][1,18,16,2,2,2,2,,1,2,4]