[1,10,9,0,0,0,0,0,0,0,0][1,10,9,0,0,0,0,0,0,0,0][1,10,9,0,0,0,0,0,0,0,0][1,10,9,0,0,0,0,0,0,0,0][1,10,9,0,0,0,0,0,0,0,0][1,10,9,0,0,0,0,0,0,0,0][1,10,9,0,0,0,0,0,0,0,0][1,10,9,0,0,0,0,0,0,0,0][1,10,9,0,0,0,0,0,0,0,0][1,10,9,0,0,0,0,0,0,0,0][1,10,9,0,0,0,0,0,0,0,0][1,10,9,0,0,0,0,0,0,0,0]
[1,10,9,0,0,0,0,0,0,0,0][0,10,9,0,0,0,0,1,0,0,0][0,10,9,0,0,0,0,1,0,0,0][0,10,9,0,0,0,0,1,0,0,0][0,10,9,0,0,0,0,1,0,0,0][0,10,9,0,0,0,0,1,0,0,0][0,10,9,0,0,0,0,1,0,0,0][0,10,9,0,0,0,0,1,0,0,0][0,10,9,0,0,0,0,1,0,0,0][0,10,9,0,0,0,0,1,0,0,0][0,10,9,0,0,0,0,1,0,0,0][1,10,9,0,0,0,0,0,0,0,0]
[1,10,9,0,0,0,0,0,0,0,0][0,10,9,0,0,0,0,1,0,0,0][0,10,9,0,0,0,0,1,0,0,0][0,10,9,0,0,0,0,1,0,0,0][0,10,9,0,0,0,0,1,0,0,0][0,10,9,0,0,0,0,1,0,0,0][0,10,9,0,0,0,0,1,0,0,0][0,10,9,1,7,2,1,1,0,0,0][0,10,9,0,0,0,0,1,0,0,0][0,10,9,0,0,0,0,1,0,0,0][0,10,9,0,0,0,0,1,0,0,0][1,10,9,0,0,0,0,0,0,0,0]
[1,10,9,0,0,0,0,0,0,0,0][0,10,9,0,0,0,0,1,0,0,0][9,10,9,0,0,0,0,0,0,0,0][0,10,9,0,0,0,0,1,0,0,0][0,10,9,0,0,0,0,1,0,0,0][0,10,9,0,0,0,0,1,0,0,0][0,10,9,0,0,0,0,1,0,0,0][0,10,9,0,0,0,0,1,0,0,0][0,10,9,0,0,0,0,1,0,0,0][0,10,9,0,0,0,0,1,0,0,0][0,10,9,0,0,0,0,1,0,0,0][1,10,9,0,0,0,0,0,0,0,0]
[1,10,9,0,0,0,0,0,0,0,0][0,10,9,0,0,0,0,1,0,0,0][0,10,9,0,0,0,0,1,0,0,0][0,10,9,0,0,0,0,1,0,0,0][0,10,9,0,0,0,0,1,0,0,0][0,10,9,0,0,0,0,1,0,0,0][0,10,9,0,0,0,0,1,0,0,0][0,10,9,0,0,0,0,1,0,0,0][0,10,9,0,0,0,0,1,0,0,0][0,10,9,0,0,0,0,1,0,0,0][0,10,9,0,0,0,0,1,0,0,0][1,10,9,0,0,0,0,0,0,0,0]
[1,10,9,0,0,0,0,0,0,0,0][0,10,9,0,0,0,0,1,0,0,0][0,10,9,0,0,0,0,1,0,0,0][0,10,9,0,0,0,0,1,0,0,0][0,10,9,0,0,0,0,1,0,0,0][0,10,9,0,0,0,0,1,0,0,0][9,10,9,0,0,0,0,0,0,0,0][0,10,9,0,0,0,0,1,0,0,0][0,10,9,0,0,0,0,1,0,0,0][0,10,9,0,0,0,0,1,0,0,0][0,10,9,0,0,0,0,1,0,0,0][1,10,9,0,0,0,0,0,0,0,0]
[1,10,9,0,0,0,0,0,0,0,0][1,17,9,0,0,0,0,0,0,0,0][1,17,9,0,0,0,0,1,0,0,0][1,17,9,0,0,0,0,0,0,0,0][8,10,9,0,0,0,0,0,0,0,0][0,10,9,0,0,0,0,1,0,0,0][0,10,9,0,0,0,0,1,0,0,0][9,10,9,0,0,0,0,0,0,0,0][10,10,9,0,0,0,0,1,0,0,0][1,10,9,0,0,0,0,0,0,0,0][8,10,9,0,0,0,0,0,0,0,0][1,10,9,0,0,0,0,0,0,0,0]
[1,10,9,0,0,0,0,0,0,0,0][0,17,9,0,0,0,0,1,0,0,0][1,17,9,0,0,0,0,1,0,0,0][1,17,9,0,0,0,0,1,0,0,0][1,17,9,0,0,0,0,0,0,0,0][0,10,9,0,0,0,0,1,0,0,0][10,10,9,0,0,0,0,0,0,0,0][0,10,9,0,0,0,0,1,0,0,0][0,10,9,0,0,0,0,1,0,0,0][0,10,9,0,0,0,0,1,0,0,0][1,10,9,0,0,0,0,0,0,0,0][1,10,9,0,0,0,0,0,0,0,0]
[1,10,9,0,0,0,0,0,0,0,0][1,17,9,2,2,2,2,0,0,0,0][0,17,9,0,0,0,0,1,0,0,0][0,17,9,0,0,0,0,1,0,0,0][0,17,17,2,2,2,2,1,0,0,0][0,10,17,0,0,0,0,1,0,0,0][10,10,17,1,1,1,1,0,0,0,0][0,10,17,0,0,0,0,1,0,0,0][0,10,17,0,0,0,0,1,0,0,0][2,10,17,0,0,0,0,1,0,0,0][1,10,9,0,0,0,0,0,0,0,0][1,10,9,0,0,0,0,0,0,0,0]
[1,10,9,0,0,0,0,0,0,0,0][0,17,9,0,0,0,0,1,0,0,0][0,17,9,0,0,0,0,1,0,0,0][0,17,9,0,0,0,0,1,0,0,0][1,17,9,0,0,0,0,0,0,0,0][0,10,9,0,0,0,0,1,0,0,0][10,10,9,0,0,0,0,0,0,0,0][0,10,9,0,0,0,0,1,0,0,0][0,10,9,0,0,0,0,1,0,0,0][0,10,9,0,0,0,0,1,0,0,0][1,10,9,0,0,0,0,0,0,0,0][1,10,9,0,0,0,0,0,0,0,0]
[1,10,9,0,0,0,0,0,0,0,0][1,17,9,0,0,0,0,0,0,0,0][10,17,9,0,0,0,0,1,0,0,0][1,17,9,0,0,0,0,0,0,0,0][7,10,9,0,0,0,0,0,0,0,0][0,10,9,0,0,0,0,1,0,0,0][0,10,9,0,0,0,0,1,0,0,0][9,10,9,0,0,0,0,0,0,0,0][10,10,9,0,0,0,1,0,0,0,0][1,10,9,0,0,0,0,0,0,0,0][7,10,9,0,0,0,0,0,0,0,0][1,10,9,0,0,0,0,0,0,0,0]
[1,10,9,0,0,0,0,0,0,0,0][0,10,9,0,0,0,0,1,0,0,0][0,10,9,0,0,0,0,1,0,0,0][0,10,9,0,0,0,0,1,0,0,0][0,10,9,0,0,0,0,1,0,0,0][0,10,9,0,0,0,0,1,0,0,0][9,10,9,0,0,0,0,0,0,0,0][0,10,9,0,0,0,0,1,0,0,0][0,10,9,0,0,0,0,1,0,0,0][0,10,9,0,0,0,0,1,0,0,0][0,10,9,0,0,0,0,1,0,0,0][1,10,9,0,0,0,0,0,0,0,0]
[1,10,9,0,0,0,0,0,0,0,0][0,10,9,0,0,0,0,1,0,0,0][0,10,9,0,0,0,0,1,0,0,0][0,10,9,0,0,0,0,1,0,0,0][0,10,9,0,0,0,0,1,0,0,0][0,10,9,0,0,0,0,1,0,0,0][0,10,9,0,0,0,0,1,0,0,0][0,10,9,0,0,0,0,1,0,0,0][0,10,9,0,0,0,0,1,0,0,0][0,10,9,0,0,0,0,1,0,0,0][0,10,9,0,0,0,0,1,0,0,0][1,10,9,0,0,0,0,0,0,0,0]
[1,10,9,0,0,0,0,0,0,0,0][0,10,9,0,0,0,0,1,0,0,0][9,10,9,0,0,0,0,0,0,0,0][0,10,9,0,0,0,0,1,0,0,0][0,10,9,0,0,0,0,1,0,0,0][0,10,9,0,0,0,0,1,0,0,0][0,10,9,0,0,0,0,1,0,0,0][0,10,9,0,0,0,0,1,0,0,0][0,10,9,0,0,0,0,1,0,0,0][0,10,9,0,0,0,0,1,0,0,0][0,10,9,0,0,0,0,1,0,0,0][1,10,9,0,0,0,0,0,0,0,0]
[1,10,9,0,0,0,0,0,0,0,0][0,10,9,0,0,0,0,1,0,0,0][0,10,9,0,0,0,0,1,0,0,0][0,10,9,0,0,0,0,1,0,0,0][0,10,9,0,0,0,0,1,0,0,0][0,10,9,0,0,0,0,1,0,0,0][0,10,9,0,0,0,0,1,0,0,0][0,10,9,0,0,0,0,1,0,0,0][0,10,9,0,0,0,0,1,0,0,0][0,10,9,0,0,0,0,1,0,0,0][0,10,9,0,0,0,0,1,0,0,0][1,10,9,0,0,0,0,0,0,0,0]
[1,10,9,0,0,0,0,0,0,0,0][0,10,9,0,0,0,0,1,0,0,0][0,10,9,0,0,0,0,1,0,0,0][0,10,9,0,0,0,0,1,0,0,0][0,10,9,0,0,0,0,1,0,0,0][0,10,9,0,0,0,0,1,0,0,0][0,10,9,0,0,0,0,1,0,0,0][0,10,9,0,0,0,0,1,0,0,0][0,10,9,0,0,0,0,1,0,0,0][0,10,9,0,0,0,0,1,0,0,0][0,10,9,0,0,0,0,1,0,0,0][1,10,9,0,0,0,0,0,0,0,0]
[1,10,9,0,0,0,0,0,0,0,0][1,10,9,0,0,0,0,0,0,0,0][1,10,9,0,0,0,0,0,0,0,0][1,10,9,0,0,0,0,0,0,0,0][1,10,9,0,0,0,0,0,0,0,0][1,10,9,0,0,0,0,0,0,0,0][1,10,9,0,0,0,0,0,0,0,0][1,10,9,0,0,0,0,0,0,0,0][1,10,9,0,0,0,0,0,0,0,0][1,10,9,0,0,0,0,0,0,0,0][1,10,9,0,0,0,0,0,0,0,0][1,10,9,0,0,0,0,0,0,0,0]