[1,18,16,0,0,0,0,,0,0,0][1,18,16,0,0,0,0,,0,0,0][1,18,16,0,0,0,0,,0,0,0][1,18,16,0,0,0,0,,0,0,0][1,18,16,0,0,0,0,,0,0,0][1,18,16,0,0,0,0,,0,0,0][1,18,16,0,0,0,0,,0,0,0][1,18,16,0,0,0,0,,0,0,0][1,18,16,0,0,0,0,,0,0,0][1,18,16,0,0,0,0,,0,0,0][1,18,16,0,0,0,0,,0,0,0][1,18,16,0,0,0,0,,0,0,0]
[1,18,16,0,0,0,0,,0,0,0][0,17,16,0,0,0,0,,0,0,0][0,17,16,0,0,0,0,,0,0,0][0,17,16,0,0,0,0,,0,0,0][0,18,16,0,0,0,0,,0,0,0][0,18,16,0,0,0,0,,0,0,0][0,18,16,0,0,0,0,,0,0,0][0,17,17,0,0,0,0,,0,0,0][0,18,16,0,0,0,0,,0,0,0][0,18,16,0,0,0,0,,0,0,0][0,18,16,0,0,0,0,,0,0,0][1,18,16,0,0,0,0,,0,0,0]
[1,18,16,0,0,0,0,,0,0,0][0,17,16,0,0,0,0,,0,0,0][0,17,16,0,0,0,0,,0,0,0][0,17,16,0,0,0,0,,0,0,0][0,18,16,0,0,0,0,,0,0,0][0,18,16,0,0,0,0,,0,0,0][0,18,16,0,0,0,0,,1,2,2][1,18,16,1,1,1,1,,0,0,0][0,18,16,0,0,0,0,,0,0,0][0,18,16,0,0,0,0,,0,0,0][2,18,16,0,0,0,0,,0,0,0][1,18,16,0,0,0,0,,0,0,0]
[1,18,16,0,0,0,0,,0,0,0][0,17,16,0,0,0,0,,0,0,0][0,17,16,0,0,0,0,,0,0,0][0,17,16,0,0,0,0,,0,0,0][0,18,16,0,0,0,0,,0,0,0][0,18,16,0,0,0,0,,0,0,0][0,18,16,0,0,0,0,,0,0,0][0,17,17,0,0,0,0,,0,0,0][0,18,16,0,0,0,0,,0,0,0][0,18,16,0,0,0,0,,0,0,0][0,18,16,0,0,0,0,,0,0,0][1,18,16,0,0,0,0,,0,0,0]
[1,18,16,0,0,0,0,,0,0,0][1,18,16,0,0,0,0,,0,0,0][1,18,16,0,0,0,0,,0,0,0][1,18,16,0,0,0,0,,0,0,0][1,18,16,0,0,0,0,,0,0,0][1,18,16,0,0,0,0,,0,0,0][1,18,16,0,0,0,0,,0,0,0][1,18,16,0,0,0,0,,0,0,0][1,18,16,0,0,0,0,,0,0,0][1,18,16,0,0,0,0,,0,0,0][1,18,16,0,0,0,0,,0,0,0][1,18,16,2,2,2,2,,0,0,0]