[1,18,16,0,0,0,0,0,0,0,0,255][1,18,16,0,0,0,0,0,0,0,0,255][1,18,16,0,0,0,0,0,0,0,0,255][1,18,16,0,0,0,0,0,0,0,0,255][1,18,16,0,0,0,0,0,0,0,0,255][1,18,16,0,0,0,0,0,0,0,0,255][1,18,16,0,0,0,0,0,0,0,0,255][1,18,16,0,0,0,0,0,0,0,0,255][1,18,16,0,0,0,0,0,0,0,0,255][1,18,16,0,0,0,0,0,0,0,0,255][1,18,16,0,0,0,0,0,0,0,0,255][1,18,16,0,0,0,0,0,0,0,0,255]
[1,18,16,0,0,0,0,0,0,0,0,255][0,18,16,0,0,0,0,1,0,0,0,255][0,18,16,0,0,0,0,1,0,0,0,255][0,18,16,0,0,0,0,1,0,0,0,255][0,18,16,0,0,0,0,1,0,0,0,255][0,18,16,0,0,0,0,1,0,0,0,255][0,18,16,0,0,0,0,1,0,0,0,255][0,18,16,0,0,0,0,1,0,0,0,255][0,18,16,0,0,0,0,1,0,0,0,255][0,18,16,0,0,0,0,1,0,0,0,255][0,18,16,0,0,0,0,1,0,0,0,255][1,18,16,0,0,0,0,0,0,0,0,255]
[1,18,16,0,0,0,0,0,0,0,0,255][0,18,16,0,0,0,0,1,0,0,0,255][0,18,16,0,0,0,0,1,0,0,0,255][0,18,16,0,0,0,0,1,0,0,0,255][0,18,16,0,0,0,0,1,0,0,0,255][0,18,16,0,0,0,0,1,0,0,0,255][0,18,16,0,0,0,0,1,0,0,0,255][0,18,16,1,7,2,1,1,0,0,0,255][0,18,16,0,0,0,0,1,0,0,0,255][0,18,16,0,0,0,0,1,0,0,0,255][0,18,16,0,0,0,0,1,0,0,0,255][1,18,16,0,0,0,0,0,0,0,0,255]
[1,18,16,0,0,0,0,0,0,0,0,255][0,18,16,0,0,0,0,1,0,0,0,255][9,18,16,0,0,0,0,0,0,0,0,255][0,18,16,0,0,0,0,1,0,0,0,255][0,18,16,0,0,0,0,1,0,0,0,255][0,18,16,0,0,0,0,1,0,0,0,255][0,18,16,0,0,0,0,1,0,0,0,255][0,18,16,0,0,0,0,1,0,0,0,255][0,18,16,0,0,0,0,1,0,0,0,255][0,18,16,0,0,0,0,1,0,0,0,255][0,18,16,0,0,0,0,1,0,0,0,255][1,18,16,0,0,0,0,0,0,0,0,255]
[1,18,16,0,0,0,0,0,0,0,0,255][0,18,16,0,0,0,0,1,0,0,0,255][0,18,16,0,0,0,0,1,0,0,0,255][0,18,16,0,0,0,0,1,0,0,0,255][0,18,16,0,0,0,0,1,0,0,0,255][0,18,16,0,0,0,0,1,0,0,0,255][0,18,16,0,0,0,0,1,0,0,0,255][0,18,16,0,0,0,0,1,0,0,0,255][0,18,16,0,0,0,0,1,0,0,0,255][0,18,16,0,0,0,0,1,0,0,0,255][0,18,16,0,0,0,0,1,0,0,0,255][1,18,16,0,0,0,0,0,0,0,0,255]
[1,18,16,0,0,0,0,0,0,0,0,255][0,18,16,0,0,0,0,1,0,0,0,255][0,18,16,0,0,0,0,1,0,0,0,255][0,18,16,0,0,0,0,1,0,0,0,255][0,18,16,0,0,0,0,1,0,0,0,255][0,18,16,0,0,0,0,1,0,0,0,255][9,18,16,0,0,0,0,0,0,0,0,255][0,18,16,0,0,0,0,1,0,0,0,255][0,18,16,0,0,0,0,1,0,0,0,255][0,18,16,0,0,0,0,1,0,0,0,255][0,18,16,0,0,0,0,1,0,0,0,255][1,18,16,0,0,0,0,0,0,0,0,255]
[1,18,16,0,0,0,0,0,0,0,0,255][1,17,16,0,0,0,0,0,0,0,0,255][10,17,16,0,0,0,0,1,0,0,0,255][1,17,16,0,0,0,0,0,0,0,0,255][8,18,16,0,0,0,0,0,0,0,0,255][0,18,16,0,0,0,0,1,0,0,0,255][0,18,16,0,0,0,0,1,0,0,0,255][9,18,16,0,0,0,0,0,0,0,0,255][10,18,16,0,0,0,0,1,0,0,0,255][1,18,16,0,0,0,0,0,0,0,0,255][8,18,16,0,0,0,0,0,0,0,0,255][1,18,16,0,0,0,0,0,0,0,0,255]
[1,18,16,0,0,0,0,0,0,0,0,255][0,17,16,0,0,0,0,1,0,0,0,255][0,17,16,0,0,0,0,1,0,0,0,255][0,17,16,0,0,0,0,1,0,0,0,255][1,17,16,0,0,0,0,0,0,0,0,255][0,18,16,0,0,0,0,1,0,0,0,255][0,18,16,0,0,0,0,1,0,0,0,255][7,18,16,0,0,0,0,1,0,0,0,255][0,18,16,0,0,0,0,1,0,0,0,255][0,18,16,0,0,0,0,1,0,0,0,255][1,18,16,0,0,0,0,0,0,0,0,255][1,18,16,0,0,0,0,0,0,0,0,255]
[1,18,16,0,0,0,0,0,0,0,0,255][9,17,16,2,2,2,2,0,0,0,0,255][0,17,16,0,0,0,0,1,0,0,0,255][0,17,16,0,0,0,0,1,0,0,0,255][0,17,17,2,2,2,2,1,0,0,0,255][0,18,17,0,0,0,0,1,0,0,0,255][0,18,17,0,0,0,0,1,0,0,0,255][9,18,17,0,0,0,0,0,0,0,0,255][0,18,17,0,0,0,0,1,0,0,0,255][2,18,17,0,0,0,0,1,0,0,0,255][1,18,16,0,0,0,0,0,0,0,0,255][1,18,16,0,0,0,0,0,0,0,0,255]
[1,18,16,0,0,0,0,0,0,0,0,255][0,17,16,0,0,0,0,1,0,0,0,255][0,17,16,0,0,0,0,1,0,0,0,255][0,17,16,0,0,0,0,1,0,0,0,255][1,17,16,0,0,0,0,0,0,0,0,255][0,18,16,0,0,0,0,1,0,0,0,255][0,18,16,0,0,0,0,1,0,0,0,255][8,18,16,0,0,0,0,1,0,0,0,255][0,18,16,0,0,0,0,1,0,0,0,255][0,18,16,0,0,0,0,1,0,0,0,255][1,18,16,0,0,0,0,0,0,0,0,255][1,18,16,0,0,0,0,0,0,0,0,255]
[1,18,16,0,0,0,0,0,0,0,0,255][1,17,16,0,0,0,0,0,0,0,0,255][10,17,16,0,0,0,0,1,0,0,0,255][1,17,16,0,0,0,0,0,0,0,0,255][7,18,16,0,0,0,0,0,0,0,0,255][0,18,16,0,0,0,0,1,0,0,0,255][0,18,16,0,0,0,0,1,0,0,0,255][9,18,16,0,0,0,0,0,0,0,0,255][10,18,16,0,0,0,0,1,0,0,0,255][1,18,16,0,0,0,0,0,0,0,0,255][7,18,16,0,0,0,0,0,0,0,0,255][1,18,16,0,0,0,0,0,0,0,0,255]
[1,18,16,0,0,0,0,0,0,0,0,255][0,18,16,0,0,0,0,1,0,0,0,255][0,18,16,0,0,0,0,1,0,0,0,255][0,18,16,0,0,0,0,1,0,0,0,255][0,18,16,0,0,0,0,1,0,0,0,255][0,18,16,0,0,0,0,1,0,0,0,255][9,18,16,0,0,0,0,0,0,0,0,255][0,18,16,0,0,0,0,1,0,0,0,255][0,18,16,0,0,0,0,1,0,0,0,255][0,18,16,0,0,0,0,1,0,0,0,255][0,18,16,0,0,0,0,1,0,0,0,255][1,18,16,0,0,0,0,0,0,0,0,255]
[1,18,16,0,0,0,0,0,0,0,0,255][0,18,16,0,0,0,0,1,0,0,0,255][0,18,16,0,0,0,0,1,0,0,0,255][0,18,16,0,0,0,0,1,0,0,0,255][0,18,16,0,0,0,0,1,0,0,0,255][0,18,16,0,0,0,0,1,0,0,0,255][0,18,16,0,0,0,0,1,0,0,0,255][0,18,16,0,0,0,0,1,0,0,0,255][0,18,16,0,0,0,0,1,0,0,0,255][0,18,16,0,0,0,0,1,0,0,0,255][0,18,16,0,0,0,0,1,0,0,0,255][1,18,16,0,0,0,0,0,0,0,0,255]
[1,18,16,0,0,0,0,0,0,0,0,255][0,18,16,0,0,0,0,1,0,0,0,255][9,18,16,0,0,0,0,0,0,0,0,255][0,18,16,0,0,0,0,1,0,0,0,255][0,18,16,0,0,0,0,1,0,0,0,255][0,18,16,0,0,0,0,1,0,0,0,255][0,18,16,0,0,0,0,1,0,0,0,255][0,18,16,0,0,0,0,1,0,0,0,255][0,18,16,0,0,0,0,1,0,0,0,255][0,18,16,0,0,0,0,1,0,0,0,255][0,18,16,0,0,0,0,1,0,0,0,255][1,18,16,0,0,0,0,0,0,0,0,255]
[1,18,16,0,0,0,0,0,0,0,0,255][0,18,16,0,0,0,0,1,0,0,0,255][0,18,16,0,0,0,0,1,0,0,0,255][0,18,16,0,0,0,0,1,0,0,0,255][0,18,16,0,0,0,0,1,0,0,0,255][0,18,16,0,0,0,0,1,0,0,0,255][0,18,16,0,0,0,0,1,0,0,0,255][0,18,16,0,0,0,0,1,0,0,0,255][0,18,16,0,0,0,0,1,0,0,0,255][0,18,16,0,0,0,0,1,0,0,0,255][0,18,16,0,0,0,0,1,0,0,0,255][1,18,16,0,0,0,0,0,0,0,0,255]
[1,18,16,0,0,0,0,0,0,0,0,255][0,18,16,0,0,0,0,1,0,0,0,255][0,18,16,0,0,0,0,1,0,0,0,255][0,18,16,0,0,0,0,1,0,0,0,255][0,18,16,0,0,0,0,1,0,0,0,255][0,18,16,0,0,0,0,1,0,0,0,255][0,18,16,0,0,0,0,1,0,0,0,255][0,18,16,0,0,0,0,1,0,0,0,255][0,18,16,0,0,0,0,1,0,0,0,255][0,18,16,0,0,0,0,1,0,0,0,255][0,18,16,0,0,0,0,1,0,0,0,255][1,18,16,0,0,0,0,0,0,0,0,255]
[1,18,16,0,0,0,0,0,0,0,0,255][1,18,16,0,0,0,0,0,0,0,0,255][1,18,16,0,0,0,0,0,0,0,0,255][1,18,16,0,0,0,0,0,0,0,0,255][1,18,16,0,0,0,0,0,0,0,0,255][1,18,16,0,0,0,0,0,0,0,0,255][1,18,16,0,0,0,0,0,0,0,0,255][1,18,16,0,0,0,0,0,0,0,0,255][1,18,16,0,0,0,0,0,0,0,0,255][1,18,16,0,0,0,0,0,0,0,0,255][1,18,16,0,0,0,0,0,0,0,0,255][1,18,16,0,0,0,0,0,0,0,0,255]