1111111
1000001
1050001
1000021
1080001
1070001
1111111
