1111111
1000001
1078001
1080001
1000001
1000001
1111111
