11111111111
10000000001
10100000001
10800000021
10700000001
10000000001
11111111111
