1111111
1000001
1010001
1080021
1070001
1000001
1111111
