[1,10,9,0,0,0,0,0,0,0,0][1,10,9,0,0,0,0,0,0,0,0][1,10,9,0,0,0,0,0,0,0,0][1,10,9,0,0,0,0,0,0,0,0]
[1,10,9,1,1,1,1,0,0,0,0][0,10,9,0,0,0,0,1,0,0,0][0,10,9,0,0,0,0,1,0,0,0][1,10,9,0,0,0,0,0,0,0,0]
[1,10,9,1,1,1,1,0,0,0,0][0,10,9,0,0,0,0,1,0,0,0][2,10,9,0,0,0,0,1,0,0,0][1,10,9,0,0,0,0,0,0,0,0]
[1,10,9,1,1,1,1,0,0,0,0][0,10,9,0,0,0,0,1,0,0,0][0,10,9,0,0,0,0,1,0,0,0][1,10,9,0,0,0,0,0,0,0,0]
[1,10,9,1,1,1,1,0,0,0,0][0,10,9,0,0,0,0,1,0,0,0][0,10,9,0,0,0,0,1,0,0,0][1,10,9,0,0,0,0,0,0,0,0]
[1,10,9,1,1,1,1,0,0,0,0][0,10,9,0,0,0,0,1,0,0,0][0,10,9,0,0,0,0,1,0,0,0][1,10,9,0,0,0,0,0,0,0,0]
[1,10,9,1,1,1,1,0,0,0,0][0,10,9,0,0,0,0,1,0,0,0][0,10,9,0,0,0,0,1,0,0,0][1,10,9,0,0,0,0,0,0,0,0]
[1,10,9,1,1,1,1,0,0,0,0][0,10,9,0,0,0,0,1,0,0,0][0,10,9,0,0,0,0,1,0,0,0][1,10,9,0,0,0,0,0,0,0,0]
[1,10,9,0,0,0,0,0,0,0,0][1,10,9,0,0,0,0,0,0,0,0][1,10,9,0,0,0,0,0,0,0,0][1,10,9,0,0,0,0,0,0,0,0]