1111111
1444441
1444441
1444421
1444441
1444441
1111111
