[1,18,16,0,0,0,0,,0,0,0,255][1,18,16,0,0,0,0,,0,0,0,255][1,18,16,0,0,0,0,,0,0,0,255][1,18,16,0,0,0,0,,0,0,0,255][1,18,16,0,0,0,0,,0,0,0,255][1,18,16,0,0,0,0,,0,0,0,255][1,18,16,0,0,0,0,,0,0,0,255]
[1,18,16,0,0,0,0,,0,0,0,255][0,17,16,0,0,0,0,,0,0,0,255][0,17,16,0,0,0,0,,0,0,0,255][0,17,16,0,0,0,0,,0,0,0,255][0,17,16,0,0,0,0,,0,0,0,255][0,17,16,0,0,0,0,,0,0,0,255][1,18,16,0,0,0,0,,0,0,0,255]
[1,18,16,0,0,0,0,,0,0,0,255][0,17,16,0,0,0,0,,0,0,0,255][9,17,16,1,1,1,1,,0,0,0,255][0,17,16,0,0,0,0,,0,0,0,255][0,17,16,0,0,0,0,,0,0,0,255][0,17,16,0,0,0,0,,0,0,0,255][1,18,16,0,0,0,0,,0,0,0,255]
[1,18,16,0,0,0,0,,0,0,0,255][0,17,16,0,0,0,0,,0,0,0,255][0,18,16,0,0,0,0,,1,2,1,255][0,17,16,0,0,0,0,,0,0,0,255][0,17,16,0,0,0,0,,0,0,0,255][2,17,16,0,0,0,0,,0,0,0,255][1,18,16,0,0,0,0,,0,0,0,255]
[1,18,16,0,0,0,0,,0,0,0,255][0,17,16,0,0,0,0,,0,0,0,255][9,17,16,1,2,2,4,,0,0,0,255][0,17,16,0,0,0,0,,0,0,0,255][0,17,16,0,0,0,0,,0,0,0,255][0,17,16,0,0,0,0,,0,0,0,255][1,18,16,0,0,0,0,,0,0,0,255]
[1,18,16,0,0,0,0,,0,0,0,255][0,17,16,0,0,0,0,,0,0,0,255][0,17,16,0,0,0,0,,0,0,0,255][0,17,16,0,0,0,0,,0,0,0,255][0,17,16,0,0,0,0,,0,0,0,255][0,17,16,0,0,0,0,,0,0,0,255][1,18,16,0,0,0,0,,0,0,0,255]
[1,18,16,0,0,0,0,,0,0,0,255][1,18,16,0,0,0,0,,0,0,0,255][1,18,16,0,0,0,0,,0,0,0,255][1,18,16,0,0,0,0,,0,0,0,255][1,18,16,0,0,0,0,,0,0,0,255][1,18,16,0,0,0,0,,0,0,0,255][1,18,16,0,0,0,0,,0,0,0,255]