[1,18,16,0,0,0,0,,0,0,0][1,18,16,0,0,0,0,,0,0,0][1,18,16,0,0,0,0,,0,0,0][1,18,16,0,0,0,0,,0,0,0][1,18,16,0,0,0,0,,0,0,0][1,18,16,0,0,0,0,,0,0,0][1,18,16,0,0,0,0,,0,0,0]
[1,18,16,0,0,0,0,,0,0,0][0,17,16,0,0,0,0,,0,0,0][0,17,16,0,0,0,0,,1,3,2][0,17,16,0,0,0,0,,0,0,0][0,17,16,0,0,0,0,,0,0,0][0,17,16,0,0,0,0,,0,0,0][1,18,16,0,0,0,0,,0,0,0]
[1,18,16,0,0,0,0,,0,0,0][0,17,16,0,0,0,0,,0,0,0][1,17,16,1,1,1,1,,0,0,0][0,17,16,0,0,0,0,,0,0,0][0,17,16,0,0,0,0,,0,0,0][0,17,16,0,0,0,0,,0,0,0][1,18,16,0,0,0,0,,0,0,0]
[1,18,16,0,0,0,0,,0,0,0][0,17,16,0,0,0,0,,0,0,0][0,18,16,0,0,0,0,,0,0,0][0,17,16,0,0,0,0,,0,0,0][0,17,16,0,0,0,0,,0,0,0][2,17,16,0,0,0,0,,0,0,0][1,18,16,0,0,0,0,,0,0,0]
[1,18,16,0,0,0,0,,0,0,0][0,17,16,0,0,0,0,,0,0,0][1,17,16,1,2,3,4,,0,0,0][0,17,16,0,0,0,0,,0,0,0][0,17,16,0,0,0,0,,0,0,0][0,17,16,0,0,0,0,,0,0,0][1,18,16,0,0,0,0,,0,0,0]
[1,18,16,0,0,0,0,,0,0,0][0,17,16,0,0,0,0,,0,0,0][0,17,16,0,0,0,0,,0,0,0][0,17,16,0,0,0,0,,0,0,0][0,17,16,0,0,0,0,,0,0,0][0,17,16,0,0,0,0,,0,0,0][1,18,16,0,0,0,0,,0,0,0]
[1,18,16,0,0,0,0,,0,0,0][1,18,16,0,0,0,0,,0,0,0][1,18,16,0,0,0,0,,0,0,0][1,18,16,0,0,0,0,,0,0,0][1,18,16,0,0,0,0,,0,0,0][1,18,16,0,0,0,0,,0,0,0][1,18,16,0,0,0,0,,0,0,0]